1111111
110P111
1100111
1100111
110C0C1
1000011
1C100E1
1111111