1111111111111111111111
1000N000N0100N0000N001
100N000000000N000N0001
1000000010C00000001001
10100010000000000000N1
100N000010101010000001
100000001N000010000001
1010101000010000101001
1000100010001010000001
1000N000101010N00N0PE1
1111111111111111111111