1111111111111111111111
1E00C00000100N0000C001
10N00C0000000C00000001
1000C000000N000N001001
10100010000N000P000001
100N000010101010000001
100C000010000010C00001
10101010000N0000100001
1111111111111111111111