1111111111111111111111
1000000000100000000001
100000C000000000000001
1000000010000000001001
1010001000000000000001
1000000010101010000001
1000000010000010000001
1010101000010000101001
1000100010001010000001
1000000010101000000PE1
1111111111111111111111