1111111
110P111
1100111
11C0111
1100001
1E00011
1010001
1111111